############
#    X   O #
#   P   ####
#          #
#######    #
#  O ##    #
#    ##    #
#  X       #
#          #
#          #
############
